Kinase/Phosphotase	Type
CLN3	Kinase Associated
CLB3	Kinase Associated
PCL9	Kinase Associated
SIP1	Kinase Associated
PCL6	Kinase Associated
CKB1	Kinase Associated
PCL10	Kinase Associated
SIP2	Kinase Associated
CLG1	Kinase Associated
CLB1	Kinase Associated
CLB6	Kinase Associated
PCL5	Kinase Associated
PCL7	Kinase Associated
MOB1	Kinase Associated
CTK2	Kinase Associated
KAE1	Kinase Associated
CLB4	Kinase Associated
CGI121	Kinase Associated
CTK3	Kinase Associated
CLN1	Kinase Associated
SSN8	Kinase Associated
PCL1	Kinase Associated
PHO80	Kinase Associated
TCO89	Kinase Associated
PCL8	Kinase Associated
CLN2	Kinase Associated
CCL1	Kinase Associated
CLB2	Kinase Associated
CLB5	Kinase Associated
PSK1	Kinase Catalytic
KIN3	Kinase Catalytic
CDC15	Kinase Catalytic
ALK2	Kinase Catalytic
FUS3	Kinase Catalytic
TEL1	Kinase Catalytic
PKC1	Kinase Catalytic
YBR028C	Kinase Catalytic
AKL1	Kinase Catalytic
VPS15	Kinase Catalytic
MEC1	Kinase Catalytic
CDC28	Kinase Catalytic
CHK1	Kinase Catalytic
KCC4	Kinase Catalytic
SAT4	Kinase Catalytic
SSK22	Kinase Catalytic
KIN82	Kinase Catalytic
CDC7	Kinase Catalytic
YDL025C	Kinase Catalytic
MPS1	Kinase Catalytic
MRK1	Kinase Catalytic
DUN1	Kinase Catalytic
KIN28	Kinase Catalytic
STE7	Kinase Catalytic
PRR2	Kinase Catalytic
KIN1	Kinase Catalytic
VHS1	Kinase Catalytic
GCN2	Kinase Catalytic
PKH3	Kinase Catalytic
SNF1	Kinase Catalytic
PKH1	Kinase Catalytic
GIN4	Kinase Catalytic
SPS1	Kinase Catalytic
YCK3	Kinase Catalytic
SAK1	Kinase Catalytic
CAK1	Kinase Catalytic
RIM15	Kinase Catalytic
CMK1	Kinase Catalytic
ALK1	Kinase Catalytic
PKP2	Kinase Catalytic
SCY1	Kinase Catalytic
ABC1	Kinase Catalytic
RCK1	Kinase Catalytic
TOS3	Kinase Catalytic
ATG1	Kinase Catalytic
KSS1	Kinase Catalytic
FMP48	Kinase Catalytic
DBF2	Kinase Catalytic
BUB1	Kinase Catalytic
BUD32	Kinase Catalytic
STE20	Kinase Catalytic
SLT2	Kinase Catalytic
IRE1	Kinase Catalytic
KSP1	Kinase Catalytic
TRA1	Kinase Catalytic
KIC1	Kinase Catalytic
YCK1	Kinase Catalytic
SCH9	Kinase Catalytic
CKA1	Kinase Catalytic
PKP1	Kinase Catalytic
PRK1	Kinase Catalytic
SLN1	Kinase Catalytic
IKS1	Kinase Catalytic
BCK1	Kinase Catalytic
IME2	Kinase Catalytic
PBS2	Kinase Catalytic
YAK1	Kinase Catalytic
TPK1	Kinase Catalytic
HAL5	Kinase Catalytic
SWE1	Kinase Catalytic
PTK2	Kinase Catalytic
TOR1	Kinase Catalytic
ELM1	Kinase Catalytic
HSL1	Kinase Catalytic
PRR1	Kinase Catalytic
YPK1	Kinase Catalytic
CTK1	Kinase Catalytic
KDX1	Kinase Catalytic
TPK3	Kinase Catalytic
KKQ8	Kinase Catalytic
NNK1	Kinase Catalytic
PTK1	Kinase Catalytic
TOR2	Kinase Catalytic
KNS1	Kinase Catalytic
KIN2	Kinase Catalytic
HOG1	Kinase Catalytic
RCK2	Kinase Catalytic
YLR253W	Kinase Catalytic
STE11	Kinase Catalytic
CDC5	Kinase Catalytic
YPK2	Kinase Catalytic
RIM11	Kinase Catalytic
SKY1	Kinase Catalytic
YMR291W	Kinase Catalytic
ARK1	Kinase Catalytic
YCK2	Kinase Catalytic
CBK1	Kinase Catalytic
NPR1	Kinase Catalytic
RIO2	Kinase Catalytic
CLA4	Kinase Catalytic
MCK1	Kinase Catalytic
SSK2	Kinase Catalytic
FPK1	Kinase Catalytic
CMK2	Kinase Catalytic
PSK2	Kinase Catalytic
PKH2	Kinase Catalytic
SKM1	Kinase Catalytic
YGK3	Kinase Catalytic
CKA2	Kinase Catalytic
RIO1	Kinase Catalytic
MKK1	Kinase Catalytic
KIN4	Kinase Catalytic
HRK1	Kinase Catalytic
MEK1	Kinase Catalytic
SKS1	Kinase Catalytic
PHO85	Kinase Catalytic
SSN3	Kinase Catalytic
YPL109C	Kinase Catalytic
MKK2	Kinase Catalytic
YPL141C	Kinase Catalytic
YPL150W	Kinase Catalytic
RAD53	Kinase Catalytic
TPK2	Kinase Catalytic
HRR25	Kinase Catalytic
IPL1	Kinase Catalytic
SMK1	Kinase Catalytic
ISR1	Kinase Catalytic
DBF20	Kinase Catalytic
SGV1	Kinase Catalytic
CDC19	Kinase Metabolic/Lipid
PGK1	Kinase Metabolic/Lipid
EKI1	Kinase Metabolic/Lipid
MSS4	Kinase Metabolic/Lipid
ADK1	Kinase Metabolic/Lipid
PRO1	Kinase Metabolic/Lipid
GUK1	Kinase Metabolic/Lipid
DAK2	Kinase Metabolic/Lipid
FAB1	Kinase Metabolic/Lipid
GUT1	Kinase Metabolic/Lipid
THR1	Kinase Metabolic/Lipid
CDC8	Kinase Metabolic/Lipid
MET14	Kinase Metabolic/Lipid
URA6	Kinase Metabolic/Lipid
CKI1	Kinase Metabolic/Lipid
VPS34	Kinase Metabolic/Lipid
LCB5	Kinase Metabolic/Lipid
STT4	Kinase Metabolic/Lipid
VIP1	Kinase Metabolic/Lipid
DAK1	Kinase Metabolic/Lipid
ERG12	Kinase Metabolic/Lipid
PIK1	Kinase Metabolic/Lipid
URK1	Kinase Metabolic/Lipid
LCB4	Kinase Metabolic/Lipid
CDC24	Other
RTG3	Other
RXT2	Other
CDC10	Other
SIR2	Other
TPS2	Other
ADR1	Other
PAM1	Other
RAD51	Other
RSP5	Other
BCK2	Other
BMH1	Other
RTG2	Other
TWF1	Other
ASK10	Other
STE12	Other
TID3	Other
PAN1	Other
NET1	Other
FAR1	Other
GRR1	Other
MGM101	Other
ALY1	Other
SFI1	Other
PUF3	Other
SSK1	Other
SIC1	Other
BUL2	Other
HOT1	Other
DOM34	Other
MKS1	Other
TEP1	Other
YNL217W	Other
RLM1	Other
GIP3	Other
YPR115W	Other
SAP155	Phosphatase Associated
CDC55	Phosphatase Associated
SAP4	Phosphatase Associated
RTS3	Phosphatase Associated
PIG2	Phosphatase Associated
SAP185	Phosphatase Associated
RTS1	Phosphatase Associated
PTC3	Phosphatase Catalytic
PTC4	Phosphatase Catalytic
PTC6	Phosphatase Catalytic
PTC1	Phosphatase Catalytic
SIT4	Phosphatase Catalytic
PPH21	Phosphatase Catalytic
PPH22	Phosphatase Catalytic
PTP1	Phosphatase Catalytic
PPZ2	Phosphatase Catalytic
PTP3	Phosphatase Catalytic
PTC2	Phosphatase Catalytic
GLC7	Phosphatase Catalytic
CDC14	Phosphatase Catalytic
PPT1	Phosphatase Catalytic
YGR203W	Phosphatase Catalytic
PTC7	Phosphatase Catalytic
SDP1	Phosphatase Catalytic
YVH1	Phosphatase Catalytic
PSR2	Phosphatase Catalytic
CNA1	Phosphatase Catalytic
PPZ1	Phosphatase Catalytic
CMP2	Phosphatase Catalytic
MIH1	Phosphatase Catalytic
MSG5	Phosphatase Catalytic
OCA1	Phosphatase Catalytic
SSU72	Phosphatase Catalytic
PPG1	Phosphatase Catalytic
PTC5	Phosphatase Catalytic
PTP2	Phosphatase Catalytic
PPQ1	Phosphatase Catalytic
PHO5	Phosphatase Metabolic/Lipid
PHO12	Phosphatase Metabolic/Lipid
INP51	Phosphatase Metabolic/Lipid
YMR1	Phosphatase Metabolic/Lipid
INP53	Phosphatase Metabolic/Lipid
